  ^^^^^^             
^^^^^^^^       ^^^   
^^^^^^^  ^^^         
^^^^^^^  ^^^         
^^^^^^^  ^^^         
---------------------
^^^^^                
   ^^^^^^^^  ^^^^^^^ 
^^^^^^^^     ^     ^ 
^^^^^        ^^^^^^^ 