^^^^^^^^^^^^^^^^^^^^^^^^^^^^
----------------------------
^^^^^^^^^^^^^^^^^^^^^^^^^^^^
^^^^ ^^^^^^^^ ^^^^^^^^^ ^^^^
^^^^ ^^  ^  ^  ^  ^  ^^ ^^^^
^^^^ ^^  ^  ^  ^  ^  ^^ ^^^^
^^^^ ^^  ^  ^  ^  ^  ^^ ^^^^
^^^^ ^^  ^  ^  ^  ^  ^^ ^^^^
^^^^ ^^  ^  ^  ^  ^  ^^ ^^^^
^^^^ ^^  ^  ^  ^  ^  ^^ ^^^^
^^^^ ^^  ^  ^  ^  ^  ^^ ^^^^
^^^^ ^^  ^  ^  ^  ^  ^^ ^^^^
^^^^ ^^  ^  ^  ^  ^  ^^ ^^^^
^^^^ ^^  ^  ^  ^  ^  ^^ ^^^^
^^^^^^^^^^^^^^^^^^^^^^^^^^^^
^^^^^^^^^^^^^^^^^^^^^^^^^^^^