------------
------------
---      ---
-- ^^^^^^ --
-   ^^^^ ^ -
--   ^^^^ --
---  ^^  ---
------------
------------