  ^^^^^     ^^^^^   
^^^^^^ ^^^^^^^^^    
--------------------
^^ ^^^^^^^^^^ ^^^^^ 
   ^^^^^^^^^^^^^^^^^
   ^^^^^^^    ^^^^^ 
      ^^^^^         
                    
^^^^^^^^^           
^^^ ^^^^      ^^^^^^
^^^^^^^^^     ^^^^^^