     ^^^^^          
^^^^^^^^^   ^^^^^   
^^^^^^^^^^  ^^^^    
^^^^^^^     ^^^^^   
^^^^^^^^            
^^          ^^^^^   
--------------------
            ^^^^^   
    ^^^^^   ^^^^^   
    ^^^^^