      ^^^^^^^^^^^^^ 
      ^^^^^^^^^^^^^ 
        ^^^^^^^^^   
--------------------
          ^^^^^^^^^^
      ^^^^^^^^^^^^^^
      ^^^^^^^       
      ^^^^^^^^  ^^^^
^^^^    ^^^^^   ^^^^
^^^     ^^^^    ^^^^
^^^^    ^^^^^   