^^^^^^^^^^
^^   ----^
^^   ^^^^^
^^   ^^^^^
^^^^   ^^^
^^^   ^^^^
^^^^^^^^^^
^^^---^^^^
^^-----^^^
^^^^---^^^
^^^  ^  ^^
^^  ^^^ ^^
^^  ^^^  ^
^^^^^^^^^^
^^^    ^^^
^^^^^^^^^^