--------^^^^^
^^^^ ^^^^^^^^
^^^ ^^^^^^^^^
^^ ^^^  ^^^^^
^^^^^  ^^^^^^
^^------^^^^^
-----^^^^^^^^
^^   ^^^^^^^^
^ ^^ ^^^^^^^^
^ ^^ ^^^^^^^^
^^  ^^^^  ^^^
^^  ^^^^---^^
^^^^^^^^^^^^^