---------------------
      ^^^^^^^^^      
    ^^^^^^^^^^^^^    
  ^^^^^^^^^^^^^^^^^  
 ^^^^^^^     ^^^^^^^ 
^^^^^^^       ^^^^^^^
^^^^^^^       ^^^^^^^
^^^^^^^       ^^^^^^^
 ^^^^^^^     ^^^^^^^ 
  ^^^^^^^^^^^^^^^^^  
    ^^^^^^^^^^^^^    
      ^^^^^^^^^      