                         
-------------------------
                         
       ^^^^^^^^^^^^^^^^^^
       ^^^^^^^^^^^^^^^^^^
       ^^^^^^^^^^^^^^^^^^
       ^^^^^        ^^^^^
       ^^^^^        ^^^^^
       ^^^^^^^^^^^^^^^^^^
       ^^^^^^^^^^^^^^^^^^
       ^^^^^^^^^^^^^^^^^^